-------------------------------------------------------------------------------------------------------------------------------------------------------------------------------------------------------------------------------------------------------------------------------------------------------------------------------------------------------------------------------------
-------------------------------------------------------------------------------------------------------------------------------------------------------------------------------------------------------------------------------------------------------------------------------------------------------------------------------------------------------------------------------------
-------------------------------------------------------------------------------------------------------------------------------------------------------------------------------------------------------------------------------------------------------------------------------------------------------------------------------------------------------------------------------------
-------------------------------------------------------------------------------------------------------------------------------------------------------------------------------------------------------------------------------------------------------------------------------------------------------------------------------------------------------------------------------------
-------------------------------------------------------------------------------------------------------------------------------------------------------------------------------------------------------------------------------------------------------------------------------------------------------------------------------------------------------------------------------------
------------------------------------------------------------------------------------------------------oo-----------------------------------------------------------------------------------------------------------------------------------------------------------------------------------------------------------------------------------------------------------------------------
---------------------------------------------------------------------------------------------------------------------------------------------------C.......-------------------------------------------------------------------------------------------------------------------------------------------------------------------------------------------------------------X------------
-----------------------------------------------------------------------------------------------------------------------------------------------------------------------------------------------------------------------------------------------------------------------------------------------------------------------------------------------------------------------XXX-----------
---------------------------------------------------------------------------------------------------------------------------------------------------------------------------------------------------------------------------------------------------------------------------------X-----------------------------------------------------------------------------------XXXXXX----------
---------------------------------------------------------o------------------------o--------o-------------------------------------------------------------------------------------C.......-------------------------------oo------------------------------------------------------XXX-oo------o----o-------------------oo---oo-----------------------------------------XXXXXXX---------
-------------------------------------------------------------------------------------------------------------------C....-------------------------------------------------------------------------------------------------------------------------------------------------------XXXXX--------------------------------------------------C...-------------------------XXXXXXXXXX--------
----------------------------------------------------#.-----C...------tt----tt-------------------------C..----------------------------tt-----------X---------X-----#.-----------------------------------------------------------C...----tt------tt--------------------C.-------XXXXXXX---------C.-------------------------------------------------tt----------------XXXXXXXXXXX-------
---------------------XX-----tt---------------------------------------tt----tt----------tt--------tt---------tt-----------------------tt-----------X---------X-----..------#..--------#.----------o---------X------------#.-------------tt--tt--tt----------oo----------------XXXXXXXXX------------------X---X---------#.-------------------------tt---------tt---XXXXXXXXXXXXXX-----F
------#...------oo---XX-----tt-----------o--------------o------------tt----tt----------tt--------tt---------tt---o-o-------oo--------tt-----------X---------X-----..-----------------..----------o---------X---oo-------..-------------tt--tt--tt---------------------------XXXXXXXXXXX-------------oo--X---X---------..----oo-------------------tt----oo---tt---XXXXXXXXXXXXXXX----X
XXXXXXXXXXXXXXXXXXXXXXXXXXXXXXXXXXXXXXXXXXXXXXXXXXXXXXXXXXXXXXXXXXXXXXXXXXXXXXXXXXXXXXXXXXXXXXXXXXXXXXXXXXXXXXXXXXXXXXXXXXXXXXXXXXXXXXXXXXXXXXXXXXXXXXXXXXXXXXXXXXXXXXXXXXXXXXXXXXXXXXXXXXXXXXXXXXXXXXXXXXXXXXXXXXXXXXXXXXXXXXXXXXXXXXXXXXXXXXXXXXXXXXXXXXXXXXXXXXXXXXXXXXXXXXXXXXXXXXXXXXXXXXXXXXXXXXXXXXXXXXXXXXXXXXXXXXXXXXXXXXXXXXXXXXXXXXXXXXXXXXXXXXXXXXXXXXXXXXXXXXXXXXXXXXXXX
XXXXXXXXXXXXXXXXXXXXXXXXXXXXXXXXXXXXXXXXXXXXXXXXXXXXXXXXXXXXXXXXXXXXXXXXXXXXXXXXXXXXXXXXXXXXXXXXXXXXXXXXXXXXXXXXXXXXXXXXXXXXXXXXXXXXXXXXXXXXXXXXXXXXXXXXXXXXXXXXXXXXXXXXXXXXXXXXXXXXXXXXXXXXXXXXXXXXXXXXXXXXXXXXXXXXXXXXXXXXXXXXXXXXXXXXXXXXXXXXXXXXXXXXXXXXXXXXXXXXXXXXXXXXXXXXXXXXXXXXXXXXXXXXXXXXXXXXXXXXXXXXXXXXXXXXXXXXXXXXXXXXXXXXXXXXXXXXXXXXXXXXXXXXXXXXXXXXXXXXXXXXXXXXXXXXX